15 26
1 2 2 2 2 2 2 2 2 2 2 2 2 2 2 2 2 2 2 2 2 2 2 2 2 2 
3 4 5 6 7 8 9 10 11 12 13 14 15 16 17 18 19 20 21 22 23 24 25 26 27 28 
29 30 31 32 33 34 35 36 37 38 39 40 41 42 43 44 45 46 47 48 49 50 51 52 53 54 
55 56 57 58 59 60 61 62 63 64 65 66 67 68 69 70 71 72 73 74 75 76 77 78 79 80 
81 82 83 84 85 86 87 88 89 90 91 92 87 87 93 94 95 96 97 87 98 99 100 101 102 87 
81 103 104 105 106 107 87 87 108 109 110 111 87 87 112 113 114 115 116 87 87 117 118 119 120 87 
121 122 123 124 125 126 127 128 129 130 131 132 133 134 135 136 137 138 139 140 141 142 143 144 145 146 
147 148 149 150 151 152 153 154 155 156 157 158 159 160 161 162 163 164 165 166 167 168 169 170 171 172 
173 174 175 176 177 178 179 180 181 182 183 184 185 186 187 188 189 190 191 192 193 194 195 196 197 198 
199 200 201 202 203 200 200 200 204 205 206 200 200 200 200 207 208 209 200 210 200 211 212 213 200 200 
199 200 214 215 216 200 200 200 217 218 219 200 200 200 200 220 221 222 200 210 200 223 224 225 200 200 
199 200 226 227 228 200 200 200 229 230 231 200 200 200 200 232 233 234 200 210 200 235 236 237 200 200 
199 200 238 239 240 200 200 200 241 242 243 200 200 200 200 244 245 246 200 210 200 247 248 249 200 200 
199 200 250 251 252 200 200 200 253 254 255 200 200 200 200 256 257 258 200 210 200 259 260 261 200 200 
262 263 264 265 266 263 263 263 267 268 269 263 263 263 263 270 271 272 263 273 263 274 275 276 263 263 